005111111600
0039999D9400
00322D999400
003999992400
00322999D400
003D99C99400
007222222800
000000000000
000000000000
000000000000
000000000000