00000000
05111160
039D9940
03999A40
039C9940
03999940
07222280
00000000