0511111116000
039999D994000
0322999994000
0399999224000
0322999994000
03999C9994000
0722222228000
0000000000000
0000000000000
0000000000000
0000000000000