0511111116000
039999D994000
0322999994000
03D9999224000
0322999994000
03D99C99D4000
0722222228000
0000000000000
0000000000000
0000000000000
0000000000000