0000000000000
0511116000000
039D994000000
03D99D4000000
039C994000000
03D99D4000000
0722228000000
0000000000000
0000000000000
0000000000000
0000000000000