00000000
05111160
03999940
03999940
039C9940
03999940
07222280
00000000